0x01 0x01 0x01 0x01 0x01
0x01 0x01 0x02 0x02 0x01
0x01 0x01 0x01 0x02 0x01
0x01 0x01 0x01 0x02 0x01
0x01 0x01 0x01 0x01 0x01